####################
#   #        #     #
# # # #### # #### ##
# #       #        #
# ##### # ####  # ##
#       #   #      #
##### # ### ### #  #
#   #       #     S#
# # ##### # ##### ##
# #     # #       ##
# ##### # # ### # ##
#       #   #     ##
##### ##### ### #  #
#                 ##
# # # # #   # # # ##
#       #          #
# #####   ### ## # #
#   #   #     #  # #
# # #   ### # # #  #
# #         #      #
# ### ### # # # #  #
####################
